64
1280
640
0,0,0,0,0,0,0,0,0,0,0,0,0,0,20,0,0,0,0,1
0,0,0,0,0,0,0,0,0,0,0,0,0,0,20,0,0,0,0,1
0,0,0,0,0,17,0,0,25,0,0,0,25,0,20,0,0,0,0,1
1,1,1,1,1,1,1,1,1,1,1,1,1,1,1,0,0,0,0,1
0,0,0,0,0,0,0,0,0,0,0,0,0,0,0,0,0,0,0,1
0,0,0,0,0,0,0,0,0,0,0,0,0,0,0,0,13,0,0,1
0,0,0,0,0,0,0,0,0,0,0,0,13,0,0,0,0,0,0,1
0,3,0,0,0,0,0,13,0,0,0,0,0,0,0,0,0,0,0,1
0,0,0,0,0,17,0,0,0,0,0,0,9,0,25,0,9,0,25,1
1,1,1,1,1,1,1,1,1,1,1,1,1,1,1,1,1,1,1,1

